11111111111111111111111111111111111111111111111111
11111111111111111111111111111111111111111111111111
11111111111111111111111111111111111111111111111111
11111111111111111111111111111111111111111111111111
11111111111111111111111410014111111111111111111111
11111111111111111111114111111411111111111111111111
11111111111111111111001110011114111111111111111111
11114411114411100111111111111111411100111114411111
21111111111111111110011111111111141111111111111443
00000000001100000000001100011000110000110001100000
